%%%%%%%%%%
%G       %
%        %
%        %
%       P%
%%%%%%%%%%
% % % % %%
%%%%%%%%%%
